1111111111111111111111111111111
1P000011100C00001110000000000E1
1010111100001100111100000010001
11100100011001011C1100011010111
10001100001111C1100001111111111
10111001011100011101110001110C1
1000001100011101100000000001001
1111101111000100111100011100001
1000001100110111101110111000111
10111110000000000011001111111C1
1C000000100C0001100000000000001
1111111111111111111111111111111