1111111111111111111111111111111111
1P001100000C1100000000011110000001
1010111000001000111100000010000001
11100100011111011C11000110001111E1
10001C00000111C1100001111111111111
10111111011111111101111111110000C1
1000001100001111100000000011000111
1111101111000111111000111111011111
1000001111110111111101111111000111
1011111000000000001100111111000001
1C0000001000000110000000000000C111
1111111111111111111111111111111111