1111111111111111111111111111111111
1A00110000001100000000011110000001
1010111000001000111100000010000001
11100100011111011011000110001111B1
1000100000011101100001111111111111
1011111101111111110111111111000001
1000001100001111100000000011000111
1111101111000111111000111111011111
1000001111110111111101111111000111
1011111000000000001100111111000001
1000000010000001100000000000000111
1111111111111111111111111111111111