1111111111111111111111111111111
1P001100000C11000000000111100E1
1010111000001000111100000010001
11100100011001011C1100011000111
10001000000111C1100001111111111
10110001011100011101100001110C1
1000001100001101100000000001001
1111101111000100011100011100001
1000001100110111101110111000111
1011111000000000001100111111001
1C000000100C00011000000000000C1
1111111111111111111111111111111