11111111111
10000000001
100000C0001
1E111111111
1P111111111
11111111111