111111
1C0001
100001
1E0001
1P0011
111111