1111111111111111111111111111111111111
100000000000000000C000000000000000001
100000000000000000C00000000000E000001
100000000000000000C000000000000000001
1CCCCC000000000000C000000000000CCCCC1
10000C000000000000C000000000000C00001
10000CC0000000000CCC0000000000CC00001
1CC00C0C00000000C0C0C00000000C0C00CC1
10C00C00C000000C00C00C000000C00C00C01
1PC00C00C000000C00C00C000000C00C00C01
10C00C00C000000C00C00C000000C00C00C01
1CC00C0C00000000C0C0C00000000C0C00CC1
10000CC0000000000CCC0000000000CC00001
10000C000000000000C000000000000C00001
1CCCCC000000000000C000000000000CCCCC1
100000000000000000C000000000000000001
100000000000000000C000000000000000001
100000000000000000C000000000000000001
1111111111111111111111111111111111111