11111111111
1P0000000E1
100000000C1
11111111111