11111111111
1P0000000E1
10000000001
100000000C1
11111111111