111111
1E0001
10C001
10P001
100001
111111